#The Shape of maze.

the_layout = [
"0 0 0 0 0 0 0 0 0 0 0 0 0 0 0 0 0 0 0 0 0 0 0 0 0 0 0 0 0 0 0 0 0 0 0",
"0 0 0 0 0 0 0 0 0 0 0 0 0 0 0 0 0 0 0 0 0 0 0 0 0 0 0 0 0 0 0 0 0 0 0",
"0 0 0 0 0 0 0 0 0 0 0 0 0 0 0 0 0 0 0 0 0 0 0 0 0 0 0 0 0 0 0 0 0 0 0",
"0 0 0 0 0 0 0 0 0 0 0 0 0 0 0 0 0 0 0 0 0 0 0 0 0 0 0 0 0 0 0 0 0 0 0",
"0 0 0 0 0 0 0 0 0 0 0 0 0 0 0 + - - - + 0 0 0 0 0 0 0 0 0 0 0 0 0 0 0",
"0 0 0 0 0 0 0 0 0 0 0 0 0 0 0 | 0 0 0 | 0 0 0 0 0 0 0 0 0 0 0 0 0 0 0",
"0 0 0 0 0 0 0 0 0 0 0 0 0 0 + + 0 0 0 + + 0 0 0 0 0 0 0 0 0 0 0 0 0 0",
"0 0 0 0 0 0 0 0 0 0 0 0 0 0 | 0 0 0 0 0 | 0 0 0 0 0 0 0 0 0 0 0 0 0 0",
"0 0 0 0 0 0 0 0 0 0 0 0 0 0 | 0 0 0 0 0 | 0 0 0 0 0 0 0 0 0 0 0 0 0 0",
"0 0 0 0 0 0 0 0 0 0 0 0 0 0 | 0 0 + 0 0 | 0 0 0 0 0 0 0 0 0 0 0 0 0 0",
"0 0 0 0 0 0 0 0 0 0 0 0 0 0 | 0 0 0 0 0 | 0 0 0 0 0 0 0 0 0 0 0 0 0 0",
"0 0 0 0 0 0 0 0 0 0 0 0 0 + + 0 0 0 0 0 + + 0 0 0 0 0 0 0 0 0 0 0 0 0",
"0 0 0 0 0 0 0 0 0 0 0 0 0 | 0 0 0 | 0 0 0 | 0 0 0 0 0 0 0 0 0 0 0 0 0",
"0 0 0 0 0 0 0 0 0 0 0 0 0 | 0 0 0 | 0 0 0 | 0 0 0 0 0 0 0 0 0 0 0 0 0",
"0 0 0 0 0 0 0 0 0 0 + - - + 0 0 - + - 0 0 + - - + 0 0 0 0 0 0 0 0 0 0",
"0 0 0 0 0 0 0 0 0 0 | 0 0 0 0 0 0 0 0 0 0 0 0 0 | 0 0 0 0 0 0 0 0 0 0",
"0 0 0 0 0 0 0 0 0 0 | 0 0 0 0 0 0 0 0 0 0 0 0 0 | 0 0 0 0 0 0 0 0 0 0",
"0 0 0 0 0 0 0 0 0 0 | 0 0 - - - - + - - - - 0 0 | 0 0 0 0 0 0 0 0 0 0",
"0 0 0 0 0 0 0 0 0 0 | 0 0 0 0 0 0 | 0 0 0 0 0 0 | 0 0 0 0 0 0 0 0 0 0",
"0 0 0 0 0 0 0 0 0 0 | 0 0 0 0 0 0 | 0 0 0 0 0 0 | 0 0 0 0 0 0 0 0 0 0",
"0 0 0 0 0 0 0 + - - + 0 0 - - 0 0 | 0 0 - - 0 0 + - - + 0 0 0 0 0 0 0",
"0 0 0 0 0 0 0 | 0 0 0 0 0 0 0 0 0 0 0 0 0 0 0 0 0 0 0 | 0 0 0 0 0 0 0",
"0 0 0 0 0 0 0 | 0 0 0 0 0 0 0 0 0 0 0 0 0 0 0 0 0 0 0 | 0 0 0 0 0 0 0",
"0 0 0 0 0 0 0 | 0 0 | 0 0 - - - - + - - - - 0 0 | 0 0 | 0 0 0 0 0 0 0",
"0 0 0 0 0 0 0 | 0 0 | 0 0 0 0 0 0 | 0 0 0 0 0 0 | 0 0 | 0 0 0 0 0 0 0",
"0 0 0 0 0 0 0 | 0 0 | 0 0 0 0 0 0 | 0 0 0 0 0 0 | 0 0 | 0 0 0 0 0 0 0",
"0 0 0 0 + - - + 0 0 | 0 0 | 0 0 0 | 0 0 0 | 0 0 | 0 0 + - - + 0 0 0 0",
"0 0 0 0 | 0 0 0 0 0 0 0 0 | 0 0 0 | 0 0 0 | 0 0 0 0 0 0 0 0 | 0 0 0 0",
"0 0 0 0 | 0 0 0 0 0 0 0 0 | 0 0 0 | 0 0 0 | 0 0 0 0 0 0 0 0 | 0 0 0 0",
"0 0 0 0 | 0 0 - - - - - - + - 0 0 | 0 0 - + - - - - - - 0 0 | 0 0 0 0",
"0 0 0 0 | 0 0 0 0 0 0 0 0 0 0 0 0 0 0 0 0 0 0 0 0 0 0 0 0 0 | 0 0 0 0",
"0 0 0 0 | 0 0 0 0 0 0 0 0 0 0 0 0 0 0 0 0 0 0 0 0 0 0 0 0 0 | 0 0 0 0",
"0 + - - + 0 0 - - - 0 0 | 0 0 - - + - - 0 0 | 0 0 - - - 0 0 + - - + 0",
"0 | 0 0 0 0 0 0 0 0 0 0 | 0 0 0 0 | 0 0 0 0 | 0 0 0 0 0 0 0 0 0 0 | 0",
"0 | 0 0 0 0 0 0 0 0 0 0 | 0 0 0 0 | 0 0 0 0 | 0 0 0 0 0 0 0 0 0 0 | 0",
"0 | 0 0 - - - - 0 0 - - + - - 0 0 | 0 0 - - + - - 0 0 - - - - 0 0 | 0",
"0 | 0 0 0 0 0 0 0 0 0 0 0 0 0 0 0 | 0 0 0 0 0 0 0 0 0 0 0 0 0 0 0 | 0",
"0 | 0 0 0 0 0 0 0 0 0 0 0 0 0 0 0 | 0 0 0 0 0 0 0 0 0 0 0 0 0 0 0 | 0",
"0 + - - - - - - - - - - - - + 0 0 | 0 0 + - - - - - - - - - - - - + 0",
"0 0 0 0 0 0 0 0 0 0 0 0 0 0 | 0 0 0 0 0 | 0 0 0 0 0 0 0 0 0 0 0 0 0 0",
"0 0 0 0 0 0 0 0 0 0 0 0 0 0 | 0 0 0 0 0 | 0 0 0 0 0 0 0 0 0 0 0 0 0 0",
"0 0 0 0 0 0 0 0 0 0 0 0 0 0 | 0 0 + 0 0 | 0 0 0 0 0 0 0 0 0 0 0 0 0 0",
"0 0 0 0 0 0 0 0 0 0 0 0 0 0 | 0 0 0 0 0 | 0 0 0 0 0 0 0 0 0 0 0 0 0 0",
"0 0 0 0 0 0 0 0 0 0 0 0 0 0 | 0 0 0 0 0 | 0 0 0 0 0 0 0 0 0 0 0 0 0 0",
"0 0 0 0 0 0 0 0 0 0 0 0 0 0 + - - - - - + 0 0 0 0 0 0 0 0 0 0 0 0 0 0",
"0 0 0 0 0 0 0 0 0 0 0 0 0 0 0 0 0 0 0 0 0 0 0 0 0 0 0 0 0 0 0 0 0 0 0"]
